111111111
100000001
100P0E001
1C0000001
111111111
